1,1,1,1,1,1,1,1,1,1,1,1,1,1,1,1,1,1,1,1
1,0,0,0,0,0,0,0,0,0,0,41,0,0,0,0,0,0,0,1
1,0,0,0,0,0,0,0,0,0,0,41,0,0,0,0,0,0,0,1
1,0,0,0,0,0,0,0,0,0,0,41,0,0,0,0,0,0,0,1
1,0,21,0,0,0,0,0,0,0,0,41,0,0,0,0,0,0,0,1
1,2,2,2,0,2,0,0,0,0,0,41,0,0,0,0,0,0,0,1
1,0,0,0,0,0,0,0,0,0,0,41,0,0,0,0,0,0,0,1
1,0,0,0,0,0,0,2,0,0,0,41,0,0,0,0,0,0,0,1
1,0,0,0,0,2,0,0,0,0,0,41,0,0,0,0,0,0,0,1
1,0,0,0,0,0,0,0,0,0,0,41,0,0,0,0,0,0,0,1
1,0,99,0,2,2,2,0,0,0,0,41,0,0,2,0,0,0,0,1
1,1,1,1,1,1,1,1,1,1,1,1,1,1,1,1,1,1,1,1
