1,1,1,1,1,1,1,1,1,1,1,1,1,1,1,1,1,1,1,1
1,0,0,0,0,0,0,0,0,0,0,41,0,0,0,0,0,0,0,1
1,0,0,0,0,0,0,0,0,0,0,41,0,0,0,0,0,0,0,1
1,0,0,0,0,0,0,0,0,0,0,41,0,0,0,0,0,0,0,1
1,0,21,0,0,0,0,0,0,0,0,41,0,0,0,0,0,0,0,1
1,2,2,2,0,2,0,0,0,0,0,41,0,0,0,0,0,0,0,1
1,0,0,0,0,0,0,0,0,0,0,41,0,0,0,0,0,0,0,1
1,0,0,0,0,0,0,2,0,0,0,41,0,0,0,0,0,0,0,1
1,0,0,0,0,2,0,0,0,0,0,41,0,0,71,71,71,0,0,1
1,0,0,0,0,0,0,0,0,0,0,41,0,0,71,0,71,0,0,1
1,0,200,0,2,2,2,0,0,0,0,41,0,0,71,2,71,0,0,1
1,1,1,1,1,1,1,1,1,1,1,1,1,1,1,1,1,1,1,1
